00000000000000000000
01111011010011011110
00000011001011000000
00000000010000000000
01111000001000001110
01001011010011011000
00000000001000000000
01001010000000000000
01111010111101010100
00000010100101010110
01111110100101010110
00000000000001010100
01111110100100000000
00000000100101011010
01111110111101001010
01111110000001001010
00010010110111111010
00010010100010000000
00010010100010111110
00000000000000000000
